26 11 3
##########################
#                        #
#      $ ##########      #
#      . #               #
#        #               #
#    .   #  @  $         #
#        #               #
#        #               #
#      $        .        #
#                        #
##########################
